8 8
1##12###
##973#3#
##6#####
##8#45##
####7###
###9####
#6#8##42
#######5
